{
    "level": [
        [157, 157, 157, 157, 157, 157, 157, 157, 157, 157, 157, 157, 157, 157, 157, 157, 157, 157, 157, 157],
        [157, 156, 156, 156, 156, 156, 156, 156, 156, 156, 156, 156, 156, 156, 156, 156, 156, 156, 156, 157],
        [157, 156, 156, 156, 156, 156, 156, 334, 156, 156, 156, 156, 156, 156, 156, 156, 156, 156, 156, 157],
        [157, 156, 156, 156, 156, 156, 156, 156, 156, 156, 156, 156, 156, 156, 156, 156, 156, 156, 156, 157],
        [157, 156, 156, 162, 156, 156, 156, 156, 156, 156, 156, 156, 156, 156, 156, 156, 156, 156, 156, 157],
        [157, 156, 156, 156, 156, 156, 274, 275, 274, 275, 156, 156, 156, 156, 156, 156, 156, 156, 156, 157],
        [157, 156, 156, 156, 156, 156, 276, 277, 276, 277, 156, 156, 156, 156, 156, 156, 280, 281, 156, 157],
        [157, 156, 156, 156, 156, 156, 278, 279, 278, 279, 156, 156, 156, 156, 156, 156, 282, 283, 156, 157],
        [157, 156, 156, 156, 156, 156, 158, 156, 156, 156, 156, 156, 156, 156, 156, 156, 284, 285, 156, 157],
        [157, 156, 156, 156, 156, 156, 156, 156, 156, 156, 156, 156, 156, 156, 156, 156, 156, 156, 156, 157],
        [157, 156, 156, 156, 156, 156, 156, 156, 156, 156, 159, 156, 156, 156, 156, 156, 156, 156, 156, 157],
        [157, 156, 156, 156, 156, 156, 156, 156, 156, 156, 156, 156, 156, 156, 333, 156, 156, 156, 156, 157],
        [157, 332, 156,  26,  27,  28, 156, 156, 156, 156, 156, 156, 156, 332, 156, 156, 156, 156, 156, 157],
        [157, 156, 156,  29,  30,  31, 156, 156, 156, 156, 156, 156, 156, 156, 156, 156, 156, 156, 156, 157],
        [157, 156, 156,  32,  33,  34, 156, 156, 156, 156, 156, 156, 156, 156, 156, 156, 156, 194, 156, 157],
        [157, 156, 156, 156, 156, 156, 156, 156, 156, 178, 179, 179, 179, 179, 179, 180, 156, 156, 156, 157],
        [157, 156, 156, 156, 156, 156, 156, 156, 266, 181, 182, 182, 182, 182, 182, 183, 156, 156, 156, 157],
        [157, 156, 156, 156, 156, 156, 156, 156, 267, 181, 182, 182, 182, 182, 182, 183, 156, 156, 156, 157],
        [157, 331, 156, 156, 156, 156, 156, 156, 268, 181, 182, 182, 182, 182, 182, 183, 156, 156, 156, 157],
        [157, 157, 157, 157, 157, 157, 157, 157, 157, 184, 185, 185, 185, 185, 185, 186, 157, 157, 157, 157],
    ],
    "indices": [
        [3, 5],
        [14, 12],
        [17, 14]
    ],
    "endpoint": [4, 13],
    "lights": [
        [0, [32 * 3.5, 32 * 12.5], 16, [245, 245, 75], 2, 0, 64]
    ],
    "npcs": [
        ["vieux", 32 * 11, 32 * 14, "back", "Cherche donc dans le sable"],
        ["ado", 32 * 10, 32 * 6, "front", "Va donc voir le panneau, qui sait ..."],
        ["enfant_fille", 32 * 13, 32 * 1, "left", "Ouvre la liste d'indices avec 'e' !"],
        ["rivale", 32 * 1, 32 * 13, "right", "On m'a dit que dans les cailloux se trouvait quelque chose"],
    ]
}
