{
    "level": [
        [9, 9, 9, 9, 9, 9, 9],
        [9, 9, 9, 9, 9, 9, 9],
        [9, 9, 9, 9, 9, 9, 9],
        [9, 9, 9, 9, 9, 9, 9],
        [9, 9, 9, 9, 2, 9, 9],
        [9, 9, 9, 9, 9, 9, 9],
        [1, 1, 1, 1, 1, 1, 1],
    ],
    "indices": [
        [0, 0],
        [5, 0],
        [0, 5]
    ],
    "endpoint": [4, 4]
}
